111111111111111111111111
10000EN00000000000C00CP1
111111111111111111111111
