1111111111
1C10000011
1111100E01
1000001101
110PC01101
1111111111