1111111111
1C00000011
1111100E00


1000001101
110PC01101
1111111111