1111111111
1C00000011
1111100E011
1000001101
110PC01101
1000000001
1000000001
1000000001
1000000001
1000000001
1111111111