111111111111111
10E0CCC0CCC00P1
111111111111111
